***********************************************************************,
*.&.................................................................&.*,
*...***************...************.......................**********...*,
*...*             *...*          *.......................*        *...*,
*...*             *...*          *.......................*        *...*,
*...*             *...************.......................*        *...*,
*...*             *..................****************....*        *...*,
*...*             *..................*              *....*        *...*,
*...***************..................****************....**********...*,
*.....................................................................*,
*...******......*****.........***************************.............*,
*...*    *......*   *.........*                         *.............*,
*...*    *......*   *.........*                         *.............*,
*...*    *......*   *.........***************************.............*,
*...*    *......*   *.................................................*,
*...*    *......*   *.................................................*,
*...******......*   *.................................................*,
*...............*   *.........***************************.............*,
*...............*   *.........*                         *.............*,
*...............*   *.........*                         *.............*,
*...............*   *.........*                         *.............*,
*...............*   *.........*                         *.............*,
*...............*   *.........***************************.............*,
*...............*****.................................................*,
*.....................................................................*,
*.....................................................................*,
*.**************************..........................................*,
*.*                        *......***************************.........*,
*.*                        *......*                         *.........*,
*.*                        *......***************************.........*,
*.**************************..........................................*,
*.&.................................................................&.*,
***********************************************************************